1111111111
1PC00E0001
1000000001
1000000001
1000000001
1000000001
1000000001
1000000011
1000000001
1111111111